Melbourne City,3000,1712,1732,872,4316,89.98400155,0.396663577,0.401297498,0.202038925
St Kilda,3182,410,533,256,1199,18.57108259,0.341951626,0.444537114,0.213511259
Southbank,3006,434,323,191,948,15.29817731,0.457805907,0.3407173,0.201476793
Richmond-Burnley,3121,420,313,201,934,15.05685081,0.449678801,0.335117773,0.215203426
Docklands,3008,313,271,194,778,16.44427002,0.402313625,0.348329049,0.249357326
East Melbourne,3002,279,223,141,643,17.31014001,0.433903577,0.34681182,0.219284603
Brunswick,3056,226,231,184,641,9.87524161,0.352574103,0.360374415,0.287051482
Hawthorn-Glenferrie,3122,252,189,163,604,7.272040421,0.417218543,0.312913907,0.26986755
Fitzroy,3065,246,200,143,589,22.95864263,0.417657046,0.339558574,0.24278438
Glen Waverley-Wheelers Hill,3150,231,181,167,579,3.099219621,0.398963731,0.312607945,0.288428325
Prahran,3181,233,198,139,570,14.70733176,0.40877193,0.347368421,0.243859649
South Yarra,3141,243,149,119,511,9.715689349,0.47553816,0.291585127,0.232876712
Carlton South,3053,219,180,111,510,11.96239544,0.429411765,0.352941176,0.217647059
Sunbury-Goonawarra,3429,149,209,151,509,5.188720174,0.292730845,0.410609037,0.296660118
Frankston,3199,204,145,159,508,12.87766503,0.401574803,0.285433071,0.312992126
Clifton Hill,3068,249,137,114,500,7.876295824,0.498,0.274,0.228
Ascot Vale-Maribyrnong,3032,194,157,127,478,12.26374147,0.405857741,0.328451883,0.265690377
Hawthorn East-Auburn,3123,270,88,76,434,3.159822928,0.622119816,0.202764977,0.175115207
Dandenong-Bangholme,3175,106,207,94,407,16.50032296,0.26044226,0.508599509,0.230958231
Hoppers Crossing,3029,156,163,86,405,7.770438138,0.385185185,0.402469136,0.212345679
Flemington-Newmarket,3031,178,147,78,403,11.6323572,0.441687345,0.364764268,0.193548387
Footscray,3011,161,128,111,400,17.90284163,0.4025,0.32,0.2775
Parkville,3052,171,134,83,388,16.75583137,0.440721649,0.345360825,0.213917526
Malvern East-Darling-Caulfield,3145,153,133,94,380,7.567719825,0.402631579,0.35,0.247368421
Abbotsford,3067,148,135,74,357,17.32219279,0.414565826,0.378151261,0.207282913
Ferntree Gully+Upper-Lysterfield,3156,155,114,86,355,5.090450147,0.436619718,0.321126761,0.242253521
Preston+East,3072,139,125,90,354,14.72347536,0.392655367,0.353107345,0.254237288
South Melbourne,3205,152,104,90,346,20.39283031,0.439306358,0.300578035,0.260115607
Brighton East,3187,97,110,129,336,2.820285823,0.288690476,0.327380952,0.383928571
Deer Park,3023,123,119,87,329,7.597436404,0.373860182,0.361702128,0.26443769
Essendon,3040,116,122,87,325,5.505279035,0.356923077,0.375384615,0.267692308
Footscray West-Maidstone,3012,144,98,77,319,8.410083452,0.451410658,0.307210031,0.24137931
Cranbourne-Skye-Devon Meadows,3977,124,100,64,288,6.321191267,0.430555556,0.347222222,0.222222222
Carnegie-Murrumbeena-Glenhuntly,3163,126,90,69,285,3.380367475,0.442105263,0.315789474,0.242105263
Belmont-Freshwater Creek,3216,129,79,73,281,4.693869702,0.459074733,0.28113879,0.259786477
Oakleigh-Oakleigh East-Huntingdale,3166,132,75,72,279,6.414216015,0.47311828,0.268817204,0.258064516
Blairgowrie,3942,85,72,112,269,4.673762147,0.31598513,0.267657993,0.416356877
Collingwood,3066,122,93,53,268,22.54522963,0.455223881,0.347014925,0.197761194
Kilmore,3764,120,73,70,263,4.525547445,0.456273764,0.27756654,0.266159696
Balaclava,3183,113,97,52,262,5.263451042,0.43129771,0.370229008,0.198473282
Delahey-Hillside,3037,103,93,63,259,5.166602671,0.397683398,0.359073359,0.243243243
North Melbourne,3051,104,91,64,259,13.84091876,0.401544402,0.351351351,0.247104247
Doncaster East,3109,126,81,52,259,2.772950789,0.486486486,0.312741313,0.200772201
Northcote,3070,120,67,70,257,7.347294939,0.46692607,0.260700389,0.272373541
Brighton+Middle+North,3186,109,77,71,257,5.057157642,0.424124514,0.299610895,0.276264591
Mordialloc,3195,100,67,89,256,5.823705355,0.390625,0.26171875,0.34765625
Bentleigh-McKinnon-Ormond,3204,118,72,66,256,4.44207912,0.4609375,0.28125,0.2578125
Brunswick West,3055,129,76,50,255,4.418586965,0.505882353,0.298039216,0.196078431
Wantirna+South-Studfield,3152,106,71,76,253,5.980087716,0.418972332,0.280632411,0.300395257
Craigieburn-Donnybrook-Kalkallo,3064,108,84,54,246,7.101214879,0.43902439,0.341463415,0.219512195
Blackburn+North+South-Laburnum,3130,102,72,69,243,3.295077115,0.419753086,0.296296296,0.283950617
South Morang,3752,109,68,64,241,5.140366006,0.452282158,0.282157676,0.265560166
Williamstown,3016,109,81,48,238,7.981284329,0.457983193,0.340336134,0.201680672
Port Melbourne,3207,98,64,71,233,16.87900282,0.420600858,0.274678112,0.30472103
Cheltenham-Cheltenham East,3192,74,93,60,227,8.205204021,0.325991189,0.40969163,0.264317181
Fawkner,3060,96,72,58,226,8.034296602,0.424778761,0.318584071,0.256637168
Sunshine-Albion,3020,65,88,72,225,13.92779641,0.288888889,0.391111111,0.32
Elwood,3184,101,61,57,219,5.390080612,0.461187215,0.278538813,0.260273973
Narre Warren,3805,90,77,51,218,6.708883994,0.412844037,0.353211009,0.233944954
Coburg+East-Moreland,3058,84,65,59,208,9.977812995,0.403846154,0.3125,0.283653846
Warrandyte,3113,78,64,65,207,1.333176026,0.376811594,0.309178744,0.314009662
Yarraville,3013,80,74,52,206,7.012439078,0.388349515,0.359223301,0.252427184
Tullamarine-Gladstone Park,3043,61,88,57,206,8.904899135,0.296116505,0.427184466,0.276699029
Albert Park,3206,97,72,37,206,6.958171109,0.470873786,0.349514563,0.17961165
Noble Park,3174,104,54,47,205,6.463878327,0.507317073,0.263414634,0.229268293
Bayswater+North,3153,90,57,57,204,8.21548479,0.441176471,0.279411765,0.279411765
Caulfield North-Crimea,3161,73,71,54,198,3.792511165,0.368686869,0.358585859,0.272727273
Thornbury,3071,88,63,44,195,6.831086894,0.451282051,0.323076923,0.225641026
Ringwood+North-Warranwood,3134,84,42,62,188,10.0192926,0.446808511,0.223404255,0.329787234
Reservoir-Keon Park,3073,69,66,52,187,7.14360686,0.368983957,0.352941176,0.278074866
Geelong+South-Bareena-Chilwell,3220,80,74,31,185,19.40210636,0.432432432,0.4,0.167567568
Pascoe Vale+South-Coburg North,3044,85,49,50,184,5.053235053,0.461956522,0.266304348,0.27173913
Wyndham vale-Mambourin-Mount Cottrell,3024,58,65,60,183,5.690153367,0.316939891,0.355191257,0.327868852
Armadale,3143,81,60,42,183,4.372146119,0.442622951,0.327868852,0.229508197
Clayton South-Clarinda-Westall,3169,80,51,52,183,3.949918801,0.43715847,0.278688525,0.284153005
West Melbourne,3003,85,54,43,182,11.77884615,0.467032967,0.296703297,0.236263736
Broadmeadows-Dallas,3047,69,61,52,182,18.96215989,0.379120879,0.335164835,0.285714286
Bentleigh East,3165,59,64,55,178,2.522758834,0.331460674,0.359550562,0.308988764
Niddrie-Airport West,3042,63,60,54,177,9.052323963,0.355932203,0.338983051,0.305084746
Carlton North,3054,74,59,44,177,6.135486982,0.418079096,0.333333333,0.248587571
Camberwell-Hartwell,3124,59,63,55,177,5.087622947,0.333333333,0.355932203,0.310734463
Mentone,3194,66,52,55,173,6.239821719,0.38150289,0.300578035,0.317919075
Heidelberg-Rosanna-Banyule-Eaglemont,3084,72,51,42,165,7.807350033,0.436363636,0.309090909,0.254545455
Croydon+South+North-Croydon Hills,3136,53,60,50,163,4.098720828,0.325153374,0.36809816,0.306748466
Bundoora-Kingsbury,3083,72,47,43,162,6.084571266,0.444444444,0.290123457,0.265432099
Wollert,3750,47,58,54,159,50.68762279,0.295597484,0.364779874,0.339622642
Altona,3018,88,33,35,156,8.345360387,0.564102564,0.211538462,0.224358974
Burwood-Bennettswood,3125,55,63,34,152,4.512991947,0.361842105,0.414473684,0.223684211
Brunswick East,3057,83,34,34,151,6.949032563,0.549668874,0.225165563,0.225165563
Mernda-Doreen,3754,66,43,42,151,6.448892387,0.437086093,0.284768212,0.278145695
Mitcham-Heatherdale-Rangeview,3132,68,47,34,149,4.381878334,0.456375839,0.315436242,0.228187919
Chelsea,3196,67,43,39,149,4.930055108,0.44966443,0.288590604,0.261744966
Mount Eliza,3930,69,49,31,149,4.638218924,0.463087248,0.32885906,0.208053691
Toorak,3142,66,43,38,147,5.500738093,0.448979592,0.292517007,0.258503401
Geelong West-Herne Hill-Manifold Heights,3218,45,61,39,145,5.344116714,0.310344828,0.420689655,0.268965517
Nunawading-Forest Hill,3131,50,53,39,142,4.771201371,0.352112676,0.373239437,0.274647887
Mount Waverley-Pinewood-Syndal,3149,58,41,43,142,4.726127755,0.408450704,0.288732394,0.302816901
Elsternwick-Gardenvale,3185,71,41,28,140,7.63502455,0.507142857,0.292857143,0.2
Mulgrave-Brandon Park,3170,62,45,32,139,4.663682212,0.446043165,0.323741007,0.230215827
Malvern-Kooyong,3144,59,40,39,138,8.208810402,0.427536232,0.289855072,0.282608696
Melton-Kurunjang-Toolern Vale,3337,52,44,40,136,10.81165877,0.382352941,0.323529412,0.294117647
Pakenham,3810,47,52,35,134,8.296040333,0.350746269,0.388059701,0.26119403
Keilor Downs-Taylors Lakes,3038,54,49,30,133,6.346331416,0.406015038,0.368421053,0.22556391
Moonee Ponds,3039,64,35,34,133,8.550735348,0.481203008,0.263157895,0.255639098
Surrey Hills-Chatham-Mont Albert,3127,58,42,33,133,3.145558074,0.436090226,0.315789474,0.248120301
Greensborough-Briar Hill,3088,55,40,35,130,5.354241451,0.423076923,0.307692308,0.269230769
St Albans+East-Kealba-Kings Park,3021,48,42,38,128,8.253673986,0.375,0.328125,0.296875
Rowville,3178,48,46,34,128,3.349915174,0.375,0.359375,0.265625
Fairfield-Alphington,3078,39,51,37,127,5.991089203,0.307086614,0.401574803,0.291338583
Kew+North-Studley Park,3101,58,34,35,127,4.004020774,0.456692913,0.267716535,0.275590551
Seaford,3198,57,35,35,127,9.748643423,0.448818898,0.275590551,0.275590551
Newport-Spotswood,3015,48,45,30,123,6.610138021,0.390243902,0.365853659,0.243902439
Ivanhoe,3079,59,37,26,122,4.485452586,0.483606557,0.303278689,0.213114754
Eltham-Research,3095,46,43,33,122,2.879675856,0.37704918,0.352459016,0.270491803
Torquay-Bellbrae-Jan Juc,3228,58,32,32,122,4.355543419,0.475409836,0.262295082,0.262295082
Laverton-Altona Meadows,3028,41,42,33,116,7.062380764,0.353448276,0.362068966,0.284482759
Clayton-Clayton North-Notting Hill,3168,46,39,31,116,8.802983661,0.396551724,0.336206897,0.267241379
Boronia,3155,40,40,32,112,7.558223289,0.357142857,0.357142857,0.285714286
Belgrave+South+Heights-Tecoma,3160,49,38,25,112,5.179239059,0.4375,0.339285714,0.223214286
Hallam,3803,54,42,12,108,7.793741389,0.5,0.388888889,0.111111111
Springvale,3171,44,40,23,107,8.760305498,0.411214953,0.373831776,0.214953271
Hampton,3188,55,27,22,104,5.291538279,0.528846154,0.259615385,0.211538462
Broadford-Tyaak,3658,51,39,14,104,4.097376993,0.490384615,0.375,0.134615385
Box Hill+South-Wattle Park,3128,42,34,27,103,9.170984456,0.40776699,0.330097087,0.262135922
Doncaster,3108,36,43,21,100,7.979302832,0.36,0.43,0.21
Warburton+East-Cambarville,3799,41,45,14,100,3.241895262,0.41,0.45,0.14
Thomastown,3074,33,35,31,99,10.16674045,0.333333333,0.353535354,0.313131313
Watsonia,3087,44,35,19,98,5.665627783,0.448979592,0.357142857,0.193877551
Moorabbin-Moorabbin East,3189,29,36,27,92,19.42078365,0.315217391,0.391304348,0.293478261
Keilor East,3033,31,31,26,88,4.759031601,0.352272727,0.352272727,0.295454545
Avondale Heights,3034,32,31,25,88,3.731003731,0.363636364,0.352272727,0.284090909
Glenroy,3046,26,32,29,87,7.467047594,0.298850575,0.367816092,0.333333333
Mooroolbark,3138,37,27,23,87,4.54347721,0.425287356,0.310344828,0.264367816
Glen Iris-Gardiner-Tooronga,3146,45,26,16,87,2.581369248,0.517241379,0.298850575,0.183908046
Endeavour Hills,3802,42,22,21,85,4.313502075,0.494117647,0.258823529,0.247058824
Bulleen,3105,34,30,20,84,3.349282297,0.404761905,0.357142857,0.238095238
Springvale South,3172,31,28,25,84,3.294738254,0.369047619,0.333333333,0.297619048
Geelong East-Breakwater-Newcomb,3219,38,21,25,84,7.435296464,0.452380952,0.25,0.297619048
Carrum Downs,3201,32,28,23,83,7.112226755,0.385542169,0.337349398,0.277108434
Mornington,3931,31,33,19,83,7.354384087,0.373493976,0.397590361,0.228915663
Berwick,3806,25,34,23,82,3.756229281,0.304878049,0.414634146,0.280487805
Balwyn-Deepdene,3103,29,31,19,79,3.276120864,0.367088608,0.392405063,0.240506329
Healesville-Mt Slide-Castella,3777,24,43,12,79,3.677537985,0.303797468,0.544303797,0.151898734
Heidelberg West-Heights,3081,19,43,16,78,11.0152473,0.243589744,0.551282051,0.205128205
Ashburton-Alamein-Ashwood,3147,21,24,33,78,4.374587821,0.269230769,0.307692308,0.423076923
Templestowe Lower,3107,32,21,22,75,3.748479319,0.426666667,0.28,0.293333333
Essendon North-Strathmore,3041,34,14,26,74,4.942630185,0.459459459,0.189189189,0.351351351
Keysborough,3173,22,31,21,74,6.059844104,0.297297297,0.418918919,0.283783784
Drysdale-Clifton Springs,3222,25,34,15,74,2.900712747,0.337837838,0.459459459,0.202702703
Rosebud,3939,28,31,13,72,8.504075788,0.388888889,0.430555556,0.180555556
Caulfield South,3162,29,24,18,71,5.530879221,0.408450704,0.338028169,0.253521127
Westmeadows-Attwood,3049,25,23,21,69,4.678429141,0.362318841,0.333333333,0.304347826
Epping,3076,31,18,18,67,10.34692173,0.462686567,0.268656716,0.268656716
Lilydale-Brookfield,3140,40,12,15,67,8.045242508,0.597014925,0.179104478,0.223880597
Braybrook,3019,28,21,17,66,13.17848411,0.424242424,0.318181818,0.257575758
Melton South-Exford,3338,24,19,23,66,8.131367462,0.363636364,0.287878788,0.348484848
Baxter,3911,21,23,18,62,5.96147967,0.338709677,0.370967742,0.290322581
Oakleigh South,3167,22,18,18,58,4.113785558,0.379310345,0.310344828,0.310344828
Mount Martha,3934,22,21,15,58,2.926201206,0.379310345,0.362068966,0.25862069
Macleod-Yallambie,3085,12,28,17,57,3.90187086,0.210526316,0.49122807,0.298245614
Carrum,3197,17,22,14,53,6.015911326,0.320754717,0.41509434,0.264150943
Leopold,3224,25,19,9,53,3.323113441,0.471698113,0.358490566,0.169811321
Taradale,3447,21,20,12,53,2.591792657,0.396226415,0.377358491,0.226415094
Mill Park-Blossom Park,3082,20,20,12,52,5.767088276,0.384615385,0.384615385,0.230769231
Altona North-Brooklyn,3025,18,16,17,51,9.772387732,0.352941176,0.31372549,0.333333333
Highett,3190,25,15,11,51,6.89856767,0.490196078,0.294117647,0.215686275
Kilsyth+South,3137,11,22,17,50,5.467318265,0.22,0.44,0.34
Black Rock-Cromer-Beaumaris,3193,20,20,10,50,2.753955148,0.4,0.4,0.2
Diamond Creek,3089,17,22,10,49,4.137691238,0.346938776,0.448979592,0.204081633
Greenvale,3059,13,23,12,48,3.968585513,0.270833333,0.479166667,0.25
Templestowe,3106,17,9,22,48,2.960446494,0.354166667,0.1875,0.458333333
Knoxfield,3180,18,17,13,48,5.574229692,0.375,0.354166667,0.270833333
Burwood East,3151,25,8,13,46,3.194951188,0.543478261,0.173913043,0.282608696
Ocean Grove-Collendina,3226,16,15,15,46,3.480684986,0.347826087,0.326086957,0.326086957
Rockbank,3335,14,16,15,45,17.49006246,0.311111111,0.355555556,0.333333333
Bacchus Marsh-Darley-Balliang,3340,19,17,8,44,5.890525146,0.431818182,0.386363636,0.181818182
Langwarrin,3910,18,15,11,44,4.169201254,0.409090909,0.340909091,0.25
Hampton Park,3976,12,19,11,42,4.434720411,0.285714286,0.452380952,0.261904762
Geelong North-Bell Park,3215,19,13,8,40,6.574167508,0.475,0.325,0.2
Gisborne-Bullengarook,3437,16,15,9,40,3.035180501,0.4,0.375,0.225
Rye-Tootgarook,3941,15,14,11,40,6.757795814,0.375,0.35,0.275
Balwyn North-Greythorn,3104,12,11,16,39,2.515135109,0.307692308,0.282051282,0.41025641
Vermont+South,3133,13,13,11,37,2.472321261,0.351351351,0.351351351,0.297297297
Little River,3211,16,11,9,36,5.5994257,0.444444444,0.305555556,0.25
Lara-Avalon,3212,22,8,6,36,5.195815071,0.611111111,0.222222222,0.166666667
Panton Hill,3759,9,17,10,36,1.554404145,0.25,0.472222222,0.277777778
Cowes,3922,13,13,10,36,7.133401971,0.361111111,0.361111111,0.277777778
Somerville-Pearcedale,3912,7,16,11,34,4.382360997,0.205882353,0.470588235,0.323529412
Kew East,3102,11,10,10,31,3.124480638,0.35483871,0.322580645,0.322580645
Portsea-Blackwarry,3944,14,10,7,31,14.79820628,0.451612903,0.322580645,0.225806452
Donvale,3111,14,10,6,30,1.704256402,0.466666667,0.333333333,0.2
Coolaroo-Meadow Heights,3048,10,10,9,29,7.532998288,0.344827586,0.344827586,0.310344828
Lalor,3075,14,10,5,29,7.104759988,0.482758621,0.344827586,0.172413793
Montmorency,3094,8,8,13,29,3.230962439,0.275862069,0.275862069,0.448275862
Ringwood East-Heathmont,3135,10,8,11,29,3.888859654,0.344827586,0.275862069,0.379310345
Kyneton-Redesdale-Tylden,3444,14,6,8,28,5.215446197,0.5,0.214285714,0.285714286
Lyndhurst,3975,13,9,6,28,4.071661238,0.464285714,0.321428571,0.214285714
Box Hill North-Mont Albert North,3129,8,11,8,27,2.328477151,0.296296296,0.407407407,0.296296296
Corio-Norlane-North Shore,3214,11,7,9,27,13.37030717,0.407407407,0.259259259,0.333333333
Keilor,3036,9,10,7,26,4.432654458,0.346153846,0.384615385,0.269230769
Park Orchards,3114,12,7,7,26,2.205486821,0.461538462,0.269230769,0.269230769
Sandringham,3191,11,10,5,26,8.21785369,0.423076923,0.384615385,0.192307692
Barwon Heads-Breamlea,3227,8,11,7,26,8.541089566,0.307692308,0.423076923,0.269230769
Red Hill,3937,5,14,7,26,2.259590121,0.192307692,0.538461538,0.269230769
Chirnside Park,3116,10,9,6,25,5.17260274,0.4,0.36,0.24
Canterbury,3126,11,7,7,25,3.118238513,0.44,0.28,0.28
Doveton,3177,9,11,5,25,9.127254998,0.36,0.44,0.2
Queenscliff-Pt Lonsdale,3225,12,7,6,25,8.709095594,0.48,0.28,0.24
Eildon,3713,11,8,6,25,11.30346232,0.44,0.32,0.24
Warragul,3820,10,6,9,25,7.140827057,0.4,0.24,0.36
Upwey,3158,7,14,3,24,4.666858128,0.291666667,0.583333333,0.125
Montrose,3765,4,13,7,24,3.505124016,0.166666667,0.541666667,0.291666667
Hastings,3915,10,3,11,24,12.29372023,0.416666667,0.125,0.458333333
Campbellfield,3061,8,7,8,23,22.53521127,0.347826087,0.304347826,0.347826087
Wandin+East+North-Seville,3139,5,12,6,23,2.672572905,0.217391304,0.52173913,0.260869565
Scoresby,3179,11,2,9,22,5.040733198,0.5,0.090909091,0.409090909
Whittlesea-Eden Park-Glenvale,3757,8,3,11,22,4.633107939,0.363636364,0.136363636,0.5
Rosebud West,3940,11,6,5,22,5.001091941,0.5,0.272727273,0.227272727
Emerald-Clematis-Avonsleigh,3782,12,4,4,20,3.204220821,0.6,0.2,0.2
Sorrento,3943,10,7,3,20,10.4281768,0.5,0.35,0.15
Hurstbridge-Arthurs Creek,3099,7,6,5,18,4.30504305,0.388888889,0.333333333,0.277777778
Lang Lang,3984,8,5,5,18,5.08617066,0.444444444,0.277777778,0.277777778
Coldstream-Gruyere-Yering,3770,6,6,5,17,2.477265601,0.352941176,0.352941176,0.294117647
Yarra Glen-Christmas Hills,3775,8,5,4,17,2.722063037,0.470588235,0.294117647,0.235294118
Wallan Wallan,3756,5,5,6,16,5.823878984,0.3125,0.3125,0.375
Yarra Junction-Powelltown,3797,4,7,5,16,4.247345409,0.25,0.4375,0.3125
Bunyip-Tonimbuk,3815,4,4,6,14,3.64010989,0.285714286,0.285714286,0.428571429
Romsey-Monegeetta North,3434,4,5,4,13,3.603807797,0.307692308,0.384615385,0.307692308
Holmesglen-Chadstone-Jordanville,3148,3,5,4,12,9.295486511,0.25,0.416666667,0.333333333
Koo Wee Rup,3981,5,3,4,12,5.208822149,0.416666667,0.25,0.333333333
Woodend-Ashbourne-Hesket,3442,4,4,3,11,3.449714842,0.363636364,0.363636364,0.272727273
Borlands-Bullarto+South,3461,8,2,1,11,2.908447142,0.727272727,0.181818182,0.090909091
Tallarook,3659,6,5,0,11,4.562737643,0.545454545,0.454545455,0
Thornton-Rubicon,3712,4,4,3,11,5.263157895,0.363636364,0.363636364,0.272727273
Sassafras+South,3787,4,7,0,11,1.484716157,0.363636364,0.636363636,0
Monbulk,3793,4,4,3,11,3.18287037,0.363636364,0.363636364,0.272727273
Dromana,3936,3,3,5,11,5.413800754,0.272727273,0.272727273,0.454545455
Clyde,3978,3,5,3,11,11.33004926,0.272727273,0.454545455,0.272727273
Laverton North,3026,2,3,5,10,567.032967,0.2,0.3,0.5
Somerton,3062,2,5,3,10,#VALUE!,0.2,0.5,0.3
Wonga Park,3115,5,4,1,10,1.72188886,0.5,0.4,0.1
The Basin,3154,0,3,7,10,3.807046583,0,0.3,0.7
Greendale-Korobeit,3341,7,1,2,10,1.773981603,0.7,0.1,0.2
Alexandra-Archeron-Taggerty,3714,8,1,1,10,3.78578024,0.8,0.1,0.1
Menzies Creek-Selby,3159,3,1,5,9,2.526233968,0.333333333,0.111111111,0.555555556
Ballan-Beremboke-Blakeville,3342,4,2,3,9,4.864,0.444444444,0.222222222,0.333333333
Diggers Rest,3427,4,1,4,9,4.923076923,0.444444444,0.111111111,0.444444444
Mount Evelyn-Kalorama-McKillop,3796,2,6,1,9,2.592276509,0.222222222,0.666666667,0.111111111
Narre Warren North+East,3804,3,3,3,9,3.430787589,0.333333333,0.333333333,0.333333333
Riddells Creek,3431,5,1,2,8,2.398081535,0.625,0.125,0.25
Kallista,3791,4,3,1,8,1.477199743,0.5,0.375,0.125
McCrae,3938,3,1,4,8,3.224537947,0.375,0.125,0.5
Heatherton,3202,2,2,3,7,3.829479769,0.285714286,0.285714286,0.428571429
Trentham-Barrys Reef,3458,2,3,2,7,4.14235706,0.285714286,0.428571429,0.285714286
Seymour-Trawool,3660,4,1,2,7,13.07630089,0.571428571,0.142857143,0.285714286
Cockatoo-Nangana,3781,3,1,3,7,2.863636364,0.428571429,0.142857143,0.428571429
Olinda,3788,2,3,2,7,6.133493686,0.285714286,0.428571429,0.285714286
Yarrambat,3091,4,1,1,6,2.450331126,0.666666667,0.166666667,0.166666667
Lower Plenty,3093,3,3,0,6,2.749867795,0.5,0.5,0
Portarlington-Indented Head,3223,2,2,2,6,4.248114514,0.333333333,0.333333333,0.333333333
New Gisbourne,3438,1,1,4,6,2.18487395,0.166666667,0.166666667,0.666666667
Beaconsfield,3807,1,2,3,6,4.167893962,0.166666667,0.333333333,0.5
Officer,3809,1,2,3,6,15.90005679,0.166666667,0.333333333,0.5
Bass,3991,0,3,3,6,11.83574879,0,0.5,0.5
Plenty,3090,3,0,2,5,2.81892021,0.6,0,0.4
Wattle Glen,3096,4,0,1,5,2.415210689,0.8,0,0.2
Frankston North,3200,3,1,1,5,10.78919303,0.6,0.2,0.2
Lancefield,3435,4,1,0,5,2.43902439,0.8,0.2,0
Kalorama,3766,2,2,1,5,2.152317881,0.4,0.4,0.2
Ferny Creek,3786,0,3,2,5,3.32247557,0,0.6,0.4
Tyabb,3913,0,3,2,5,6.47307925,0,0.6,0.4
Balnarringg,3926,3,2,0,5,0,0.6,0.4,0
Flinders,3929,1,1,3,5,9.186046512,0.2,0.2,0.6
Moorooduc,3933,1,3,1,5,4.474708171,0.2,0.6,0.2
Macedon,3440,1,3,0,4,3.594420601,0.25,0.75,0
Molesworth,3718,0,1,3,4,#VALUE!,0,0.25,0.75
Mount Dandenong,3767,2,1,1,4,2.344381568,0.5,0.25,0.25
Merricks-Shoreham,3916,2,1,1,4,7.167235495,0.5,0.25,0.25
Bittern,3918,1,3,0,4,3.108348135,0.25,0.75,0
Mount Macedon,3441,1,2,0,3,1.892505678,0.333333333,0.666666667,0
Smiths Gully,3760,2,0,1,3,0,0.666666667,0,0.333333333
Marysville,3779,1,2,0,3,18.83408072,0.333333333,0.666666667,0
Tremont,3785,1,1,1,3,#VALUE!,0.333333333,0.333333333,0.333333333
The Patch,3792,2,0,1,3,1.83044316,0.666666667,0,0.333333333
Garfield,3814,1,0,2,3,2.554744526,0.333333333,0,0.666666667
Drouin+South+West-Jindivick,3818,2,0,1,3,4.781206055,0.666666667,0,0.333333333
Noojee-Loch Valley-Tanjil Bren,3833,0,1,2,3,11.9873817,0,0.333333333,0.666666667
Somers,3927,0,3,0,3,2.522775053,0,1,0
Tooradin,3980,3,0,0,3,4.54248366,1,0,0
Clarkefield,3430,0,1,1,2,3.233256351,0,0.5,0.5
Wandongg,3758,0,2,0,2,4.299065421,0,1,0
HMAS Cerebus,3920,1,0,1,2,1.105990783,0.5,0,0.5
Leongatha-Hallston-Trida-Ruby,3953,1,1,0,2,5.15039143,0.5,0.5,0
Ardeer,3022,1,0,0,1,20.43924903,1,0,0
Kangaroo Ground-Watsons Creek,3097,0,1,0,1,2.548262548,0,1,0
null,3213,1,0,0,1,#VALUE!,1,0,0
Yea-Flowerdale-Glenburn,3717,1,0,0,1,3.840361446,1,0,0
Woodstock,3751,0,1,0,1,5.637982196,0,1,0
Yan Yean,3755,0,0,1,1,5.016722408,0,0,1
St Andrews-Mittons Bridge,3761,1,0,0,1,2.021089631,1,0,0
Narbethong,3778,0,0,1,1,1.265822785,0,0,1
Gembrook,3783,1,0,0,1,4.32759423,1,0,0
Sherbrooke,3789,0,1,0,1,3.358208955,0,1,0
Beaconsfield Upper,3808,0,1,0,1,4.568357407,0,1,0
Nar Nar Goon-Maryknoll,3812,1,0,0,1,3.261348612,1,0,0
Tynong,3813,0,0,1,1,1.990950226,0,0,1
Longwarry+South+North,3816,0,0,1,1,4.76673428,0,0,1
Main Ridge,3928,0,0,1,1,0.426439232,0,0,1
Meeniyan-Tarwin-Meadows,3956,0,1,0,1,5.232295895,0,1,0
Nyora,3987,0,1,0,1,2.702702703,0,1,0
Oaklands Junction-Yuroke,3063,0,0,0,0,2.798232695,#DIV/0!,#DIV/0!,#DIV/0!
Deakin University,3217,0,0,0,0,0,#DIV/0!,#DIV/0!,#DIV/0!
Bulla,3428,0,0,0,0,8.9093702,#DIV/0!,#DIV/0!,#DIV/0!
Bolinda,3432,0,0,0,0,#VALUE!,#DIV/0!,#DIV/0!,#DIV/0!
Monegeeta,3433,0,0,0,0,2.803738318,#DIV/0!,#DIV/0!,#DIV/0!
Malmsbury-Drummond North,3446,0,0,0,0,12.09150327,#DIV/0!,#DIV/0!,#DIV/0!
Buxton,3711,0,0,0,0,4.6692607,#DIV/0!,#DIV/0!,#DIV/0!
Beveridge,3753,0,0,0,0,8.027522936,#DIV/0!,#DIV/0!,#DIV/0!
Bylands,3762,0,0,0,0,#VALUE!,#DIV/0!,#DIV/0!,#DIV/0!
Kinglake,3763,0,0,0,0,5.196733482,#DIV/0!,#DIV/0!,#DIV/0!
Silvan+South-Burleigh,3795,0,0,0,0,3.032786885,#DIV/0!,#DIV/0!,#DIV/0!
Crib Point,3919,0,0,0,0,7.220852413,#DIV/0!,#DIV/0!,#DIV/0!
Tankerton,3921,0,0,0,0,0,#DIV/0!,#DIV/0!,#DIV/0!
Rhyll,3923,0,0,0,0,1.78041543,#DIV/0!,#DIV/0!,#DIV/0!
Loch-Krowera-Woodleigh,3945,0,0,0,0,2.585315408,#DIV/0!,#DIV/0!,#DIV/0!
Bena,3946,0,0,0,0,#VALUE!,#DIV/0!,#DIV/0!,#DIV/0!
Kernot-Korrine,3979,0,0,0,0,0.750750751,#DIV/0!,#DIV/0!,#DIV/0!
Poowong+East+North-Topiram,3988,0,0,0,0,1.56424581,#DIV/0!,#DIV/0!,#DIV/0!
Glen Forbes,3990,0,0,0,0,#VALUE!,#DIV/0!,#DIV/0!,#DIV/0!
